{
  "name": "Built-In Classic",
  "cols": 36,
  "rows": 36,
  "playerStart": { "c": 2, "r": 2 },
  "map": [
    [1,1,1,1,1,1,1,1,1,1,1,1,1,1,1,1,1,1,1,1,1,1,1,1,1,1,1,1,1,1,1,1,1,1,1,1],
    [1,0,0,0,0,0,1,0,6,0,0,0,0,1,0,0,0,0,0,1,0,0,0,0,0,0,1,0,0,0,0,0,0,0,0,1],
    [1,0,0,2,0,0,1,0,0,0,2,0,0,0,0,0,7,0,0,1,0,0,0,0,2,0,0,0,0,0,0,0,22,0,0,1],
    [1,0,0,0,0,0,1,0,0,0,0,0,1,0,0,0,0,0,0,1,0,0,0,0,0,0,1,0,2,0,0,0,0,0,0,1],
    [1,0,4,0,3,0,10,0,0,0,0,0,1,12,0,0,0,0,0,1,0,8,0,0,0,0,1,0,0,0,0,0,0,0,0,1],
    [1,0,0,0,0,0,1,0,0,0,0,0,1,0,0,0,0,0,0,0,0,0,0,0,0,0,0,0,0,0,0,0,0,0,0,1],
    [1,0,0,2,0,0,11,0,0,9,0,0,1,0,0,0,2,0,0,1,0,0,3,0,0,0,1,0,0,7,0,0,0,0,0,1],
    [1,0,0,0,0,0,1,0,0,9,0,0,0,0,0,0,0,0,0,1,0,0,0,0,0,0,0,0,0,0,0,0,0,0,0,1],
    [1,1,0,1,1,1,1,0,0,0,0,0,0,0,0,0,0,0,0,1,0,0,0,0,0,0,0,0,0,0,0,0,0,0,0,1],
    [1,0,0,0,0,0,0,0,5,0,0,0,1,0,0,2,0,0,0,1,0,0,0,0,14,0,0,0,0,0,0,0,0,0,0,1],
    [1,0,0,0,2,0,0,0,0,0,0,0,1,0,0,0,0,0,6,1,0,0,0,0,0,0,0,0,0,0,0,0,0,0,0,1],
    [1,0,0,0,0,0,0,0,18,18,18,18,18,0,0,0,0,0,0,1,0,0,0,0,0,0,0,0,22,0,0,0,0,0,0,1],
    [1,0,3,0,0,0,0,0,16,16,0,0,0,0,0,0,0,0,0,1,1,1,1,0,1,1,1,1,0,0,0,0,0,0,0,1],
    [1,0,0,0,0,0,1,1,1,0,1,1,1,0,2,0,0,0,0,0,0,0,0,0,0,0,0,0,0,0,0,0,0,0,0,1],
    [1,0,0,7,0,0,1,0,0,0,0,0,1,0,0,0,23,0,0,0,0,0,0,0,0,0,0,0,0,0,0,0,0,0,0,1],
    [1,0,0,0,0,0,1,0,0,0,0,0,1,0,0,3,0,0,0,0,0,17,0,0,0,0,0,0,0,0,0,0,0,0,0,1],
    [1,0,0,0,0,0,1,0,2,0,0,0,1,13,0,0,0,0,0,1,1,1,0,1,1,1,0,1,1,1,1,1,1,1,1,1],
    [1,1,1,0,1,1,1,0,0,0,0,0,0,0,0,0,0,6,0,0,0,0,0,0,0,0,0,0,0,0,0,0,0,0,0,1],
    [1,0,0,0,0,0,0,0,0,0,0,0,0,0,4,0,0,0,0,0,0,0,0,0,0,0,0,0,0,0,0,0,0,0,0,1],
    [1,0,2,0,0,0,0,0,25,25,25,0,0,0,0,0,0,0,0,0,0,0,2,0,0,0,0,0,0,0,0,0,0,0,0,1],
    [1,0,0,0,0,0,1,1,1,1,1,0,1,1,1,1,0,0,0,0,0,0,0,0,0,0,0,0,0,0,0,0,0,0,0,1],
    [1,0,0,0,5,0,0,0,0,0,0,0,0,0,0,0,0,0,0,0,0,3,0,0,0,0,0,0,0,0,0,0,0,0,0,1],
    [1,0,0,0,0,0,0,0,20,0,0,0,0,0,0,0,0,0,0,0,0,0,0,0,2,0,0,0,0,0,0,0,0,0,0,1],
    [1,0,0,9,0,0,0,0,20,8,0,0,1,0,0,0,0,2,0,0,0,0,0,0,0,0,0,0,24,0,0,0,0,0,0,1],
    [1,0,0,9,0,0,0,0,20,0,0,0,1,0,7,0,0,0,0,0,0,0,0,0,0,0,0,0,24,0,0,0,0,0,0,1],
    [1,0,0,0,0,0,1,0,0,0,0,0,0,0,0,0,0,0,0,1,0,0,0,0,0,0,2,0,0,0,0,0,0,0,0,1],
    [1,0,0,0,0,0,1,0,0,0,0,0,0,0,0,0,0,0,0,1,0,0,0,0,0,0,0,0,0,0,0,0,0,0,0,1],
    [1,0,14,0,0,0,0,0,0,0,0,0,0,0,0,0,0,0,0,1,0,0,0,0,0,0,0,3,0,0,0,0,0,0,0,1],
    [1,0,0,0,0,0,0,0,0,0,0,0,0,0,0,0,0,0,0,0,0,0,0,0,0,0,0,0,0,0,0,0,0,0,15,1],
    [1,0,0,0,0,0,1,0,6,0,0,2,1,0,0,0,0,0,0,1,0,0,2,0,0,0,0,0,0,0,0,0,0,0,0,1],
    [1,0,0,0,4,0,1,21,21,21,21,0,0,0,0,0,0,0,0,1,0,0,0,0,0,0,0,0,0,0,0,0,0,0,0,1],
    [1,0,0,0,0,0,0,0,0,0,0,0,0,0,0,0,0,0,0,0,0,2,0,0,0,0,0,0,0,0,0,0,0,0,0,1],
    [1,0,0,0,0,0,0,0,0,0,0,0,0,0,0,0,0,0,0,0,0,0,0,0,0,0,0,0,0,0,0,0,0,0,0,1],
    [1,0,0,0,0,22,0,0,0,0,0,0,0,0,0,0,2,0,0,0,0,0,0,0,0,0,0,0,0,0,0,0,0,0,0,1],
    [1,0,0,0,0,0,0,0,0,0,0,0,0,0,0,0,0,0,0,0,0,0,0,0,0,0,0,0,0,0,0,0,0,0,0,1],
    [1,1,1,1,1,1,1,1,1,1,1,1,1,1,1,1,1,1,1,1,1,1,1,1,1,1,1,1,1,1,1,1,1,1,1,1]
  ],
  "robots": [
    {"c":8,  "r":2,  "axis":"h", "range":4, "speed":1.0, "type":"normal"},
    {"c":15, "r":4,  "axis":"v", "range":4, "speed":0.9, "type":"normal"},
    {"c":8,  "r":10, "axis":"h", "range":3, "speed":1.2, "type":"fast"},
    {"c":20, "r":6,  "axis":"v", "range":5, "speed":0.8, "type":"normal"},
    {"c":14, "r":20, "axis":"h", "range":5, "speed":1.1, "type":"normal"},
    {"c":25, "r":15, "axis":"v", "range":4, "speed":0.9, "type":"fast"},
    {"c":3,  "r":19, "axis":"v", "range":3, "speed":1.3, "type":"normal"},
    {"c":19, "r":24, "axis":"h", "range":4, "speed":1.0, "type":"heavy"},
    {"c":10, "r":29, "axis":"h", "range":4, "speed":1.4, "type":"fast"},
    {"c":22, "r":29, "axis":"v", "range":2, "speed":1.5, "type":"heavy"},
    {"c":30, "r":10, "axis":"v", "range":6, "speed":0.7, "type":"normal"},
    {"c":28, "r":20, "axis":"h", "range":5, "speed":1.1, "type":"normal"}
  ],
  "cameras": [
    {"c":16, "r":14, "range":6, "angleStart":0,                  "angleSweep":2.5132741228718345},
    {"c":28, "r":23, "range":5, "angleStart":3.141592653589793,  "angleSweep":2.199114857512855}
  ],
  "warpPairs": [
    {"from": {"c":24, "r":9}, "to": {"c":2, "r":27}}
  ]
}
